18 18
******************
*                *
*                *
*                *
*                *
* *    ******** **
*                *
*                *
*                *
*                *
*                *
*                *
*                *
*                *
*                *
*                *
*                *
******************