18 18
******************
*________________*
*________________*
*________________*
*________________*
***____********_**
*________________*
*________________*
*________________*
*________________*
*________________*
*________________*
*________________*
*________________*
*________________*
*________________*
*________________*
******************